XXXXXXXXXXXXXXXXXXXXXXXXXXX
XOQQQQQQQQQQQQQQQQQQQQQQQOX
XQXXXTXQXXQXGXQXQXXQXTXXXQX
XQXGQQXQXXQXQXQXQXXQXQQQXQX
XQXQXQXQQQQXQXQXQQQQXQXQXQX
XQXQXQXQXXQTQMQTQXXQXQXQXQX
XQXQXQXQQQQXQXQXQQQQXQXQXQX
XQXQQQXQXXQXQXQXQXXQXQQGXQX
XQXXXTXQXXQXQXGXQXXQXTXXXQX
XOQQQQQQQQQQQTQQQQQQQQQQQOX
XXXXXXXXXXXXXXXXXXXXXXXXXXX